111111111111111111111111111111111111111111111111111111111
100000C10000000000000000000000001000000000000000000000001
101110111111111111101111111111101011111111111111111100P01
1000100000000000000000000000C0100010C00000000000000000001
101111111111111111111111111111111111111111111111111111111
10001C1000000000000010000000000C100000101C000000001000001
101110111010111111101011101110111010111011111011111011101
1010001000101000100000100010000000100000001C101000100C101
101011101110101111101111111110111010101110101010101111101
100010001000100010001000000000101010101C00000000100010101
111011101010111011111110111011101110111111111110101110101
1000000010101000100000101C0010000010100000100000100010001
111011101111111010111010111111101110101111101111111110111
10100C1000000000000C1010000010000010001010101000000010001
101011111011101010111011101010111011111010111111101110111
100000100010001010100010101010101010000000000010000010001
111110111011111011111110111010101111111110101111101110101
100000100000100010001010000000001C10000000101000000010101
101110111111101110111011111110101010111111111010101111101
1010001000001010000000001C0010100000001000000010100010101
101011101111111010111011111010101110101110111111111010101
1C10000010101C1010101010100000100010100000001000000000001
111111101010101010101110111111111011111110101110111010111
100010001C00000010001010001000100000001000101000100010001
111011101110111110101011101011101011101111111111101111101
100000000000100000100000100000001010000000001000000010101
111011111110111111111111111010101010111011111011101010111
101010000C10001010100000000010101010101010001010101000001
1010101111111010101011111011111111101C1111101010111010101
10000000000010001000000C1000000010C0CC10000000001C00101E1
111111111111111111111111111111111111111111111111111111111