111111111
1ECCC0P11
100111111
10CCC0011
111011111
10CCC0011
111111111