111111111
10000C001
100000001
111000001
101000001
101C00C01
1E1000001
1010P0001
100000001
111111111


