11111
1MDR1
10P01
10C01
10E01
11111