111111
10P001
100001
100111
1C01E1
111111