1111111
100C001
10P0001
10000E0
10C0001
1111111