111111
100C01
1P001
100E11
111111