111111011
100P0E0C1
100000001
111111111