111111111
000P000C1
100000001
111111111