111111111
100P0E0C0
100000001
111111111